1 13 31
###############################
#p      2     *  ** * *  1   *#
# # # # #*# # #*# # # # # #*# #
#      * *** **      *    **  #
# #*# # # # #1# #b#1# # # # #*#
#      1   *     **      *  **#
# # #*# # # # # #*#*#*#*# # # #
#   *    x#  *   * * * *      #
# # # # #*# # # # # # #*# #*# #
#   * **         *1           #
# # # # # # # # # #*# # # # #*#
#  ** *   *    2              #
###############################

Meta data:
(Number or Level) (Rows) (Columns)

Info Tiles:
# - Wall
* - Brick
x - Portal

Mobs:
p - Player
1 - Balloom
2 - Oneal

Powerups:
b - Powerup Bombs
f - Powerup Flames
s - Powerup Speed